000-054_dat-0090
000-055_dat-0001
000-056_dat-0003
000-057_dat-0005
000-058_dat-0007
000-059_dat-0009
000-060_dat-0011
000-061_dat-0013
000-062_dat-0015
000-063_dat-0017
000-064_dat-0019
000-065_dat-0021
000-066_dat-0023
000-067_dat-0025
000-068_dat-0027
000-069_dat-0029
000-070_dat-0031
000-071_dat-0033
000-072_dat-0035
000-073_dat-0037
000-074_dat-0045
000-075_dat-0047
000-076_dat-0049
000-077_dat-0051
000-078_dat-0053
000-079_dat-0055
000-080_dat-0057
000-081_dat-0059
000-082_dat-0061
000-083_dat-0063
000-084_dat-0065
000-085_dat-0067
000-086_dat-0069
000-088_dat-0079
000-089_dat-0081
000-090_dat-0085
000-091_dat-0087
000-098_dat-0089
