000-054_dat-0002
000-055_dat-0004
000-056_dat-0006
000-057_dat-0008
000-058_dat-0010
000-059_dat-0012
000-060_dat-0014
000-061_dat-0016
000-062_dat-0018
000-063_dat-0020
000-064_dat-0022
000-065_dat-0024
000-066_dat-0026
000-067_dat-0028
000-068_dat-0030
000-069_dat-0032
000-070_dat-0034
000-071_dat-0036
000-072_dat-0038
000-073_dat-0040
000-074_dat-0048
000-075_dat-0050
000-076_dat-0052
000-077_dat-0054
000-078_dat-0056
000-079_dat-0058
000-080_dat-0060
000-081_dat-0062
000-082_dat-0064
000-083_dat-0066
000-084_dat-0068
000-085_dat-0070
000-086_dat-0072
000-088_dat-0082
000-089_dat-0084
000-090_dat-0088
000-091_dat-0090
000-098_dat-0092
